5 
# # #   # 
#   #   # 
    # # # 
#   # #   
  #   #   
